5,5
1,1,1,1,1
1,1,-1,1,1
1,1,5160,1,1
1,1,0,1,1
1,1,2,1,1
level5
