10,6
1,1,1,1,1,1,1,1,1,1
1,0,0,5160,0,5060,0,5160,0,1
1,2,0,5160,0,5060,0,5160,0,1
1,1,1,1,1,1,1,1,3,1
1,-1,0,0,0,0,0,0,3,1
1,1,5160,5160,1,5060,5060,5060,1,1
