8,7
1,1,1,1,1,1,1,1
1,3,0,0,0,0,0,1
1,3,0,1,1,1,425,1
1,3,0,3,1,0,0,1
1,1,1,3,1,0,1,1
1,-1,0,3,1,0,0,1
1,1,1,1,1,1,1,1
