10,8
1,1,1,1,1,1,1,1,1,1
1,0,0,0,0,0,0,0,0,1
1,435,0,0,0,0,0,1,0,1
1,402,0,0,0,0,0,1,0,1
1,0,0,0,0,0,0,1,0,1
1,0,0,402,0,0,0,1,0,1
1,0,0,0,0,0,-1,1,2,1
1,1,1,1,402,1,1,1,1,1
