10,8
1,1,1,1,1,1,1,1,1,1
1,2,0,0,0,0,0,0,0,1
1,1,1,0,411,0,0,0,0,1
1,0,0,401,411,0,0,0,0,1
1,0,0,401,411,403,1,0,0,1
1,0,0,401,0,403,0,0,0,1
1,-1,0,0,0,403,0,402,402,1
1,1,1,1,1,1,1,1,1,1
